0 0 0 0 0 0 0 0 0 0 0 0 0 0 0 0 0 0 0 0 0 0 0 0 0 0 0 0 0 0 0 30 66 66 66 66 66 66 66 31 0 30 66 66 66 66 66 66 66 66 
0 30 66 66 66 66 66 66 31 0 0 0 0 0 0 0 0 0 0 0 0 0 0 0 0 0 0 0 0 0 0 30 67 67 67 67 67 67 67 31 30 66 67 67 67 67 67 67 67 67 
0 30 67 67 67 67 67 67 31 0 30 66 66 66 66 66 66 66 66 31 0 30 66 66 66 66 31 0 0 0 0 30 67 67 67 67 67 67 67 66 66 67 67 67 67 67 67 67 67 67 
0 30 67 67 67 67 67 67 66 66 66 67 67 67 67 67 67 67 67 66 66 66 67 67 67 67 66 66 66 66 31 30 67 67 67 67 67 67 67 8 67 67 67 0 0 0 0 0 0 0 
0 30 67 67 67 67 67 67 67 67 67 67 67 67 67 67 67 67 67 67 67 67 67 67 67 67 67 67 67 67 66 66 67 67 67 67 67 67 67 67 67 67 0 0 0 0 0 0 0 0 
0 30 67 67 67 67 67 67 67 67 67 67 67 67 67 67 67 67 67 67 67 67 67 67 67 67 66 66 67 67 67 67 67 67 67 67 67 67 67 67 67 67 0 0 0 0 0 0 0 0 
0 30 67 67 67 67 67 67 66 66 66 67 67 67 67 67 67 67 67 66 66 66 67 67 67 67 31 30 67 67 67 67 67 67 67 67 67 67 67 66 67 67 67 0 0 0 0 0 0 0 
0 30 67 67 67 67 67 67 29 0 28 67 67 67 67 67 67 67 67 29 0 28 66 67 67 66 29 28 66 66 66 66 67 67 67 67 67 67 67 9 66 67 67 67 67 67 67 67 67 67 
0 28 66 66 66 66 66 66 29 0 30 67 67 67 67 67 67 67 67 31 0 0 30 67 67 31 32 27 27 27 27 28 66 66 67 67 66 66 66 29 28 66 67 67 67 67 67 67 67 67 
0 0 0 0 0 0 0 0 0 0 30 67 67 67 67 67 67 67 67 31 0 0 30 67 67 31 30 67 67 67 67 31 0 28 67 67 29 0 0 0 0 28 66 66 66 66 66 66 66 66 
0 0 0 0 30 66 66 66 31 0 30 67 67 67 67 67 67 67 67 31 0 0 30 67 67 16 17 67 67 67 67 31 0 30 67 67 31 0 0 0 0 0 0 0 0 0 0 0 0 0 
0 0 30 66 66 67 67 67 31 0 30 67 67 66 66 66 66 66 66 29 0 0 30 67 67 67 67 67 67 67 67 31 0 30 67 67 31 30 66 66 31 30 66 66 31 30 66 66 31 0 
0 30 66 67 67 67 67 67 31 0 30 67 67 29 0 0 0 0 0 0 0 0 30 67 67 68 68 68 68 68 68 31 0 30 67 67 31 30 67 67 31 30 67 67 31 30 67 67 31 0 
0 30 67 67 67 67 67 67 31 0 30 67 67 31 0 0 0 0 0 0 0 0 30 67 67 9 9 9 9 9 9 29 0 30 67 67 31 30 67 67 31 30 67 67 31 30 67 67 31 0 
0 30 67 67 67 67 67 67 66 66 66 67 67 31 0 0 0 0 0 0 0 0 30 67 67 8 16 26 26 33 0 0 0 30 67 67 31 30 67 67 31 30 67 67 31 30 67 67 31 0 
0 30 67 67 67 67 67 67 67 67 67 67 67 31 0 0 0 0 0 0 0 0 30 67 67 8 8 9 9 31 0 0 0 30 67 67 66 66 67 67 66 66 67 67 66 66 67 67 31 0 
0 30 67 67 67 67 67 67 67 67 67 67 67 31 0 0 0 0 0 0 0 0 30 67 67 67 67 67 67 31 0 0 0 30 67 67 67 67 67 67 67 67 67 67 67 67 67 67 31 0 
0 30 67 67 67 67 67 67 66 66 66 67 67 31 0 0 0 0 0 0 0 0 30 67 67 67 67 67 67 31 0 0 0 30 67 67 67 67 67 67 67 67 67 67 67 67 67 67 31 0 
0 30 67 67 67 67 67 67 29 0 28 67 67 31 0 0 0 0 0 0 0 0 30 67 67 67 67 67 67 31 0 0 0 30 67 67 66 66 67 67 66 66 67 67 66 66 67 67 29 0 
0 30 67 67 67 67 67 67 31 0 30 67 67 31 0 0 0 0 0 0 0 0 30 67 67 68 69 69 69 31 0 0 0 30 67 67 29 28 67 67 0 28 67 67 29 28 67 67 29 0 
0 28 66 67 67 67 67 67 31 0 30 67 67 31 0 0 0 0 0 0 0 0 30 67 67 20 8 8 8 29 0 0 0 30 67 67 31 28 67 67 0 28 67 67 29 28 67 67 29 0 
0 0 28 66 66 67 67 67 31 0 30 67 67 31 0 0 0 0 0 0 0 0 30 67 67 31 0 0 0 0 0 0 0 30 67 67 31 28 67 67 0 28 67 67 29 28 67 67 29 0 
0 0 0 0 28 66 66 66 29 0 30 67 67 31 0 0 0 0 0 0 0 0 30 67 67 31 0 0 0 0 0 0 0 30 67 67 31 28 8 8 0 28 10 10 29 28 10 10 29 0 
0 0 0 0 0 0 0 0 0 0 30 67 67 31 0 0 0 0 0 0 30 66 66 67 67 66 66 31 0 0 0 0 0 30 67 67 31 0 0 0 0 0 0 0 0 0 0 0 0 0 
0 0 0 0 0 0 0 0 0 0 30 67 67 31 0 0 0 0 30 66 66 67 67 67 67 67 67 66 66 31 0 0 0 30 67 67 66 66 66 66 66 66 66 66 66 66 66 66 66 66 
0 0 0 0 0 0 0 0 0 0 30 67 67 31 0 0 0 30 66 67 67 0 0 0 0 0 0 67 67 66 31 0 0 30 67 67 67 67 67 67 67 67 67 67 67 67 67 67 67 67 
0 0 0 0 0 0 0 0 0 0 30 67 67 31 0 0 30 66 67 0 0 0 0 0 0 0 0 0 0 67 66 66 66 66 67 67 67 67 67 67 67 67 67 67 67 67 67 67 67 67 
0 30 66 66 66 66 66 66 66 66 66 67 67 31 0 0 30 67 67 0 0 0 0 67 67 0 0 0 0 67 67 67 67 67 67 67 67 67 67 67 67 67 67 67 67 67 67 67 67 67 
0 30 67 67 67 67 67 67 67 67 67 67 67 31 0 0 30 67 67 0 0 0 0 67 67 0 0 0 0 67 67 67 67 67 67 67 8 8 8 67 8 8 8 8 67 8 8 8 67 67 
0 30 67 67 67 67 67 67 67 67 67 67 67 31 0 0 28 66 67 0 0 0 67 67 67 67 0 0 0 67 66 66 66 66 67 67 29 32 25 67 16 33 32 25 67 16 33 28 67 67 
0 30 67 67 0 0 0 0 0 0 0 0 0 31 0 0 0 28 67 67 67 67 67 67 67 67 67 67 67 67 29 0 0 28 66 66 29 30 67 6 67 31 30 67 67 67 31 30 67 67 
0 30 67 67 0 0 0 0 0 0 0 0 0 31 0 0 0 28 66 66 66 66 66 67 67 66 66 66 66 66 29 0 0 0 0 0 0 30 1 67 67 31 30 67 67 67 31 30 67 67 
0 30 67 67 67 67 67 67 67 67 67 67 67 31 0 0 0 0 0 0 0 0 28 67 67 29 0 0 0 0 0 0 0 0 0 0 0 30 6 67 67 31 30 67 1 67 31 30 67 67 
0 30 68 68 68 68 68 68 68 68 68 67 67 31 0 0 0 0 0 0 0 0 30 67 67 31 0 0 0 0 0 0 0 0 0 0 0 30 67 67 67 31 30 67 67 67 31 30 67 67 
0 0 0 0 0 0 0 0 0 0 30 67 67 31 0 0 0 0 0 0 0 0 30 67 67 31 0 0 0 0 0 0 0 0 0 0 0 30 67 1 67 31 30 67 67 67 31 30 67 67 
0 0 0 0 0 0 0 0 0 0 30 67 67 31 0 0 0 0 0 0 30 66 66 67 67 66 66 31 0 0 0 0 0 0 0 0 0 30 67 67 67 31 30 67 67 67 31 30 67 67 
0 30 66 66 66 66 66 66 66 66 66 67 67 66 66 31 0 0 0 0 30 67 67 67 67 67 67 31 0 0 0 0 0 0 0 0 0 28 66 67 66 29 28 66 67 66 29 30 67 67 
0 30 67 67 67 67 67 67 67 67 67 67 67 67 67 31 0 0 30 66 66 67 67 67 67 67 67 66 66 31 0 0 0 0 0 0 0 0 28 8 29 0 0 28 9 29 0 30 67 67 
0 30 67 67 67 67 67 67 67 67 67 67 67 67 67 31 0 0 30 67 67 67 67 67 67 67 67 67 67 31 0 0 0 0 0 0 0 0 0 0 0 0 0 0 0 0 0 30 67 67 
0 30 67 67 67 67 67 67 67 67 67 67 67 67 67 31 0 0 30 67 67 67 67 67 67 67 67 67 67 31 0 0 0 0 0 0 0 0 0 0 0 0 0 0 0 0 0 30 67 67 
0 30 67 67 67 67 67 67 67 67 67 67 67 67 67 31 0 0 30 67 67 67 67 67 67 67 67 67 67 31 0 30 66 66 31 30 66 66 31 0 0 0 0 0 0 0 0 30 67 67 
0 30 67 67 67 67 67 67 67 67 67 67 67 67 67 31 0 0 30 67 67 67 67 67 67 67 67 67 67 31 0 30 67 67 31 30 67 67 31 0 0 0 0 0 30 66 66 66 67 67 
0 30 67 67 67 67 67 67 67 67 67 67 67 67 67 31 0 0 28 66 66 67 67 67 67 67 67 66 66 29 0 30 67 67 66 66 67 67 31 0 30 66 66 66 66 67 67 67 67 67 
0 30 67 67 67 67 67 67 67 67 67 67 67 67 67 31 0 0 32 34 17 67 67 67 67 67 67 24 34 26 26 30 67 67 67 67 67 67 31 0 30 67 67 67 67 67 67 67 67 67 
0 30 67 67 67 67 67 67 67 67 67 67 67 67 67 31 0 0 30 67 67 67 67 67 67 67 67 67 67 8 8 66 67 67 67 67 67 67 31 0 30 67 67 4 4 67 67 67 67 67 
0 30 67 67 67 67 67 67 67 67 67 67 67 67 67 31 0 0 30 67 67 67 67 67 67 67 67 67 67 67 67 67 67 67 67 67 67 67 66 66 66 67 67 0 0 2 67 67 67 67 
0 28 66 66 66 66 66 66 66 66 66 66 66 66 66 29 0 0 30 67 67 67 67 67 67 67 67 67 67 67 67 67 67 67 67 67 67 67 67 67 67 67 67 0 0 0 0 0 0 0 
0 0 65 65 65 65 65 65 65 65 65 65 65 65 65 0 0 0 30 67 67 67 67 67 67 67 67 67 67 66 66 66 67 67 67 67 67 67 67 6 7 67 67 67 67 67 67 67 67 67 
0 0 0 0 0 0 0 0 0 0 0 0 0 0 0 0 0 0 28 66 66 66 67 67 67 67 66 66 66 29 0 0 66 66 66 66 66 67 67 67 67 67 67 67 67 67 67 67 67 67 
0 0 0 0 0 0 0 0 0 0 0 0 0 0 0 0 0 0 0 65 65 65 73 73 73 73 65 65 65 0 0 0 65 65 65 65 28 66 66 66 66 66 66 66 66 67 67 67 67 67