0 32 19 15 19 19 15 19 33 0 0 0 0 0 0 0 0 0 0 0 0 0 0 0 0 0 0 0 0 0 0 32 15 18 15 59 15 18 15 0 32 59 27 27 27 27 27 27 59 33 
0 30 42 57 8 10 57 42 31 0 32 36 15 15 18 18 15 15 36 33 0 32 18 59 18 18 33 0 0 0 0 30 57 41 9 50 9 41 57 59 17 52 10 42 10 42 10 42 50 31 
0 30 67 57 6 7 57 67 16 35 25 64 57 9 55 10 9 57 64 24 18 25 9 52 55 9 16 18 36 18 33 30 57 67 58 43 58 3 57 9 10 46 2 67 67 67 67 7 44 31 
0 30 67 58 67 67 58 67 9 11 9 67 58 58 65 65 58 58 37 9 12 9 65 47 56 67 9 23 64 9 16 17 58 67 67 67 67 67 58 40 67 67 67 65 67 38 67 65 37 31 
0 30 67 67 67 67 67 67 67 67 67 67 5 67 67 67 67 67 67 67 67 67 67 67 67 67 67 67 67 65 11 11 67 67 38 67 38 67 67 67 6 7 67 15 67 65 67 15 67 31 
0 30 67 1 67 67 67 67 68 68 68 67 67 38 67 67 38 67 7 68 68 68 1 3 67 67 68 68 67 67 38 67 67 67 67 3 67 67 67 67 67 67 67 57 67 15 67 57 67 31 
0 30 39 67 67 5 67 67 13 9 14 67 1 67 67 67 67 67 38 13 9 14 68 67 67 68 13 14 68 68 68 68 3 67 38 67 38 67 67 40 69 5 67 58 67 57 67 58 67 31 
0 30 71 74 74 68 69 69 31 0 30 38 67 67 67 6 7 67 67 31 0 28 14 67 67 13 29 28 64 8 23 14 68 68 67 67 68 68 72 9 14 68 67 38 67 58 67 38 67 31 
0 28 8 22 9 9 23 8 29 0 30 67 67 38 67 67 38 67 67 31 0 0 30 67 67 16 18 27 27 27 33 28 22 14 67 67 13 10 23 29 28 9 68 68 68 69 68 68 68 31 
0 0 0 0 32 18 18 18 33 0 30 67 3 67 67 1 67 67 39 31 0 0 30 65 67 6 7 67 4 38 31 0 0 30 67 67 31 0 0 0 0 28 64 11 64 10 64 10 64 29 
0 0 0 18 25 8 9 9 31 0 30 67 67 68 68 68 68 68 68 31 0 0 30 1 67 67 67 67 1 4 31 0 0 30 98 99 31 32 27 27 33 32 27 27 33 32 27 27 33 0 
0 32 17 9 9 67 67 67 31 0 30 67 67 13 10 23 12 9 9 29 0 0 30 67 67 67 67 67 67 38 31 0 0 30 103 104 31 30 22 64 31 30 42 23 31 30 55 11 31 0 
0 30 9 67 67 67 67 67 31 0 30 67 67 31 0 0 0 0 0 0 0 0 30 67 65 68 68 68 68 69 31 0 0 30 103 104 31 30 67 67 31 30 67 67 31 30 67 67 31 0 
0 30 67 96 102 102 97 67 24 18 25 67 67 31 0 0 0 0 0 0 0 0 30 67 67 13 42 9 41 9 29 0 0 30 103 104 31 30 67 67 31 30 67 67 31 30 67 67 31 0 
0 30 67 100 120 120 101 67 9 9 9 67 67 31 0 0 0 0 0 0 0 0 30 67 67 24 15 15 26 33 0 0 0 30 103 104 16 17 67 67 16 17 67 67 24 25 67 67 31 0 
0 30 67 100 120 120 101 67 67 67 67 67 67 31 0 0 0 0 0 0 0 0 30 7 67 8 57 9 9 31 0 0 0 30 103 104 10 10 67 67 10 10 67 67 10 10 67 67 31 0 
0 30 67 100 120 120 101 67 68 68 68 67 67 31 0 0 0 0 0 0 0 0 30 65 67 38 58 58 38 31 0 0 0 30 103 121 105 105 105 105 105 105 105 105 105 105 105 105 31 0 
0 30 67 100 120 120 101 67 13 9 14 67 67 31 0 0 0 0 0 0 0 0 30 67 67 67 67 67 67 31 0 0 0 30 103 121 111 111 111 111 111 111 111 111 111 111 111 111 31 0 
0 30 67 100 120 120 101 67 31 0 30 67 67 31 0 0 0 0 0 0 0 0 30 67 67 38 67 67 38 31 0 0 0 30 103 104 13 14 67 67 13 14 67 67 13 14 67 67 31 0 
0 30 69 106 108 108 107 67 31 0 30 67 67 31 0 0 0 0 0 0 0 0 30 67 65 69 69 69 69 31 0 0 0 30 103 104 31 30 67 67 31 30 67 67 31 30 67 67 31 0 
0 28 14 69 69 67 67 67 31 0 30 67 67 31 0 0 0 0 0 0 0 0 30 67 67 20 8 55 8 29 0 0 0 30 103 104 31 30 67 67 31 30 67 67 31 30 67 67 31 0 
0 0 28 8 14 69 69 69 31 0 30 67 67 31 0 0 0 0 0 0 0 0 30 67 67 31 0 0 0 0 0 0 0 30 103 104 31 30 68 68 31 30 68 68 31 30 68 68 31 0 
0 0 0 0 28 8 8 8 29 0 30 67 67 31 0 0 0 0 0 0 0 18 17 67 67 24 18 0 0 0 0 0 0 30 103 104 31 28 40 8 29 28 64 55 29 28 42 23 29 0 
0 0 0 0 0 0 0 0 0 0 30 67 67 31 0 0 0 0 32 18 59 20 8 67 67 8 21 59 18 33 0 0 0 30 109 110 16 15 18 18 15 15 18 18 15 15 18 18 15 33 
0 0 0 0 0 0 0 0 0 0 30 67 67 31 0 0 0 32 17 42 54 1 4 67 67 4 2 52 42 16 33 0 0 30 67 67 8 57 23 8 57 22 11 10 22 57 8 22 57 31 
0 0 0 0 0 0 0 0 0 0 30 67 67 31 0 0 32 17 64 67 47 0 0 0 0 0 0 46 67 64 16 19 19 17 67 67 5 58 65 67 58 58 67 67 58 58 65 37 58 31 
0 0 0 0 0 0 0 0 0 0 17 67 67 16 0 0 30 41 67 0 0 0 0 0 0 0 0 0 0 67 41 9 9 9 67 4 67 67 67 67 67 67 65 67 67 1 67 67 67 31 
0 0 0 0 0 0 0 0 0 0 67 67 67 67 0 0 30 67 0 0 0 0 0 0 0 0 0 0 0 0 39 67 67 67 67 67 68 68 68 67 68 68 68 68 68 69 68 67 67 31 
0 0 0 0 0 0 0 0 0 0 0 67 67 0 0 0 30 68 0 0 0 0 0 67 67 0 0 0 0 0 4 68 68 68 4 67 13 23 14 67 13 42 23 42 9 42 14 3 67 31 
0 0 0 0 0 0 0 0 0 0 0 0 0 0 0 0 28 21 67 0 0 0 67 67 67 67 0 0 0 67 10 11 10 21 68 68 31 32 25 67 24 33 0 0 0 0 30 67 67 31 
0 0 0 0 0 0 0 0 0 0 0 0 0 0 0 0 0 30 68 68 68 68 68 114 116 68 68 68 68 68 29 0 0 28 9 9 29 30 67 6 67 24 18 18 18 18 25 67 3 31 
0 0 0 0 0 0 0 0 0 0 0 0 0 0 0 0 0 28 10 10 9 12 14 77 79 13 8 11 8 10 29 0 0 0 0 0 0 30 1 67 67 9 9 9 9 9 10 5 67 31 
0 0 0 0 0 0 0 0 0 0 0 0 0 0 0 0 0 0 65 65 65 65 30 77 79 31 65 65 65 65 0 0 0 0 0 0 0 30 6 67 67 38 38 67 67 38 38 67 67 31 
0 0 0 0 0 0 0 0 0 0 0 0 0 0 0 0 0 0 0 0 0 0 30 77 79 31 0 0 0 0 0 0 0 0 0 0 0 30 67 67 67 68 68 68 68 68 68 67 67 31 
0 0 0 0 0 0 0 0 0 0 30 67 67 31 0 0 0 0 0 0 32 15 17 117 119 16 15 33 0 0 0 0 0 0 0 0 0 30 67 1 67 13 9 9 9 9 14 67 67 31 
0 32 18 18 18 18 18 18 18 18 25 67 67 24 35 33 0 0 0 0 30 57 42 67 67 42 57 31 0 0 0 0 0 0 0 0 0 30 69 67 69 31 0 0 0 0 30 38 67 31 
0 30 9 10 12 22 12 12 12 9 9 67 67 22 9 31 0 0 32 15 17 57 4 96 97 4 57 24 15 33 0 0 0 0 0 0 0 28 14 68 13 29 0 0 0 0 30 67 67 31 
0 30 67 67 67 67 67 67 67 67 67 67 67 67 67 16 18 18 17 50 64 58 96 120 120 97 58 64 50 31 0 0 0 0 0 0 0 0 28 64 29 0 0 0 0 0 30 6 7 31 
0 30 67 96 102 102 102 102 102 102 102 102 102 97 67 9 9 9 9 44 65 96 120 120 120 120 97 65 45 31 0 0 0 0 0 0 0 0 0 0 0 0 0 0 0 0 30 67 38 31 
0 30 67 100 120 120 120 120 120 120 120 120 120 101 67 67 67 67 67 67 96 120 120 120 120 120 120 97 67 31 0 32 15 15 33 32 15 15 33 0 0 0 0 0 0 0 30 67 67 31 
0 30 67 100 120 120 120 120 120 120 120 120 120 101 67 68 68 67 67 67 106 120 120 120 120 120 120 107 67 31 0 30 57 9 31 30 9 57 31 0 0 0 0 0 32 18 25 67 67 31 
0 30 67 100 120 120 120 120 120 120 120 120 120 101 67 13 9 9 9 68 68 100 120 120 120 120 101 68 68 31 0 30 58 58 16 17 58 58 31 0 32 18 18 18 25 9 40 67 67 31 
0 30 67 100 120 120 120 120 120 120 120 120 120 101 67 31 0 0 28 8 14 100 120 120 120 120 101 13 9 29 0 30 67 67 42 42 67 67 31 0 30 10 40 10 10 67 67 67 67 31 
0 30 67 100 120 120 120 120 120 120 120 120 120 101 67 31 0 0 32 34 17 100 120 120 120 120 101 24 34 26 26 25 67 67 67 67 2 67 31 0 30 67 3 67 67 67 67 67 67 31 
0 30 67 100 120 120 120 120 120 120 120 120 120 101 67 31 0 0 30 38 67 100 120 120 120 120 101 67 38 7 67 67 2 3 67 67 67 67 16 34 17 67 67 4 4 67 1 67 67 31 
0 30 67 100 120 120 120 120 120 120 120 120 120 101 67 31 0 0 30 67 96 120 120 120 120 120 120 97 67 67 67 67 67 67 67 67 67 67 11 55 8 67 67 0 0 2 67 67 67 31 
0 30 67 106 108 108 108 108 108 108 108 108 108 107 67 31 0 0 30 38 106 108 120 120 120 120 108 107 38 68 68 68 3 67 2 67 67 67 67 67 67 67 67 0 0 0 0 0 0 31 
0 30 68 68 68 68 68 68 68 68 68 68 68 68 68 31 0 0 30 68 68 68 106 108 108 107 68 68 68 13 9 14 68 68 68 68 68 67 67 6 7 67 67 67 67 67 67 67 67 31 
0 28 8 10 8 8 8 8 8 10 8 8 8 10 8 29 0 0 28 10 8 14 68 68 68 68 13 9 9 29 0 28 9 9 9 9 9 69 69 69 69 69 69 69 69 69 69 69 69 31 
0 0 65 65 65 65 65 65 65 65 65 65 65 65 65 0 0 0 0 0 0 28 9 9 9 9 29 0 0 0 0 0 0 0 0 0 28 9 64 22 9 41 9 9 41 22 12 64 12 29 
