0 32 19 19 19 19 19 19 33 0 0 0 0 0 0 0 0 0 0 0 0 0 0 0 0 0 0 0 0 0 0 32 18 18 18 18 18 18 18 33 32 27 27 27 27 27 27 27 27 33 
0 30 10 10 51 10 10 10 31 0 32 36 36 36 36 36 15 36 36 33 0 32 18 18 18 18 33 0 0 0 0 30 9 52 9 50 9 55 9 31 30 9 10 42 10 42 10 42 9 31 
0 30 67 67 44 67 67 67 16 35 25 8 8 9 52 10 57 10 8 31 0 30 9 9 55 9 31 0 0 0 0 30 67 47 67 43 67 56 67 66 66 67 67 67 67 67 67 67 67 31 
0 30 67 67 67 67 67 67 9 9 9 67 67 67 46 67 57 67 67 66 66 66 67 67 56 67 66 66 66 66 31 30 67 67 67 67 67 67 67 8 67 67 67 0 67 0 67 0 67 31 
0 30 67 67 67 67 67 67 67 67 67 67 67 67 67 67 58 67 67 67 67 67 67 67 67 67 67 67 67 67 66 66 67 67 38 67 38 67 67 67 67 67 67 0 67 0 67 0 67 31 
0 30 67 67 67 67 67 67 68 68 68 67 67 67 67 67 67 67 67 68 68 68 67 67 67 67 68 68 67 67 67 67 67 67 67 67 67 67 67 67 67 67 67 0 67 0 67 0 67 31 
0 30 67 67 67 67 67 67 13 9 14 67 67 67 67 67 67 67 67 13 9 14 68 67 67 68 13 14 68 68 68 68 67 67 38 67 38 67 67 9 68 67 67 0 67 0 67 0 67 31 
0 30 74 74 74 74 69 69 31 0 30 67 67 67 67 67 67 67 67 31 0 28 14 67 67 13 29 28 9 9 9 14 68 68 67 67 68 68 68 10 14 67 67 0 67 0 67 0 67 31 
0 28 9 9 9 9 9 9 29 0 30 67 67 67 67 67 67 67 67 31 0 0 30 67 67 16 18 27 27 27 33 28 9 14 67 67 9 9 9 29 28 66 67 67 67 67 67 67 67 31 
0 0 0 0 32 18 18 18 33 0 30 67 67 67 67 67 67 67 67 31 0 0 30 67 67 67 67 67 67 67 31 0 0 30 67 67 29 0 0 0 0 28 66 66 66 66 66 66 66 29 
0 0 0 18 25 8 9 9 31 0 30 67 67 68 68 68 68 68 68 31 0 0 30 67 67 67 67 67 67 67 31 0 0 30 67 67 31 32 27 27 33 32 27 27 33 32 27 27 33 0 
0 32 17 9 9 67 67 67 31 0 30 67 67 13 9 9 9 9 9 29 0 0 30 67 67 67 67 67 67 67 31 0 0 30 67 67 31 30 10 10 31 30 10 10 31 30 10 10 31 0 
0 30 9 67 67 67 67 67 31 0 30 67 67 31 0 0 0 0 0 0 0 0 30 67 67 68 68 68 68 68 31 0 0 30 67 67 31 30 67 67 31 30 67 67 31 30 67 67 31 0 
0 30 67 67 67 67 67 67 24 18 25 67 67 31 0 0 0 0 0 0 0 0 30 67 67 13 9 9 9 9 29 0 0 30 67 67 31 30 67 67 31 30 67 67 31 30 67 67 31 0 
0 30 67 67 67 67 67 67 9 9 9 67 67 31 0 0 0 0 0 0 0 0 30 67 67 24 18 26 26 33 0 0 0 30 67 67 16 17 67 67 16 17 67 67 24 25 67 67 31 0 
0 30 67 67 67 67 67 67 67 67 67 67 67 31 0 0 0 0 0 0 0 0 30 67 67 8 8 9 9 31 0 0 0 30 67 67 10 10 67 67 10 10 67 67 10 10 67 67 31 0 
0 30 67 67 67 67 67 67 68 68 68 67 67 31 0 0 0 0 0 0 0 0 30 67 67 67 67 67 67 31 0 0 0 30 67 67 67 67 67 67 67 67 67 67 67 67 67 67 31 0 
0 30 67 67 67 67 67 67 13 9 14 67 67 31 0 0 0 0 0 0 0 0 30 67 67 67 67 67 67 31 0 0 0 30 67 67 68 68 67 67 68 68 67 67 68 68 67 67 31 0 
0 30 67 67 67 67 67 67 31 0 30 67 67 31 0 0 0 0 0 0 0 0 30 67 67 67 67 67 67 31 0 0 0 30 67 67 13 14 67 67 13 14 67 67 13 14 67 67 31 0 
0 30 69 67 67 67 67 67 31 0 30 67 67 31 0 0 0 0 0 0 0 0 30 67 67 68 69 69 69 31 0 0 0 30 67 67 31 30 67 67 31 30 67 67 31 30 67 67 31 0 
0 28 14 69 69 67 67 67 31 0 30 67 67 31 0 0 0 0 0 0 0 0 30 67 67 20 8 8 8 29 0 0 0 30 67 67 31 30 67 67 31 30 67 67 31 30 67 67 31 0 
0 0 28 8 14 69 69 69 31 0 30 67 67 31 0 0 0 0 0 0 0 0 30 67 67 31 0 0 0 0 0 0 0 30 67 67 31 30 68 68 31 30 68 68 31 30 68 68 31 0 
0 0 0 0 28 8 8 8 29 0 30 67 67 31 0 0 0 0 0 0 32 18 25 67 67 24 18 33 0 0 0 0 0 30 67 67 31 28 8 8 29 28 10 10 29 28 10 10 29 0 
0 0 0 0 0 0 0 0 0 0 30 67 67 31 0 0 0 0 0 0 30 8 8 67 67 8 8 31 0 0 0 0 0 30 67 67 16 18 18 18 18 18 18 18 18 18 18 18 18 33 
0 0 0 0 0 0 0 0 0 0 30 67 67 31 0 0 0 0 30 66 66 67 67 67 67 67 67 66 66 31 0 0 0 30 67 67 8 8 11 8 8 11 11 8 8 11 8 11 8 31 
0 0 0 0 0 0 0 0 0 0 30 67 67 31 0 0 0 30 66 67 67 0 0 0 0 0 0 67 67 66 31 0 0 30 67 67 67 67 67 67 67 67 67 67 67 67 67 67 67 31 
0 0 0 0 0 0 0 0 0 0 17 67 67 16 0 0 30 66 67 0 0 0 0 0 0 0 0 0 0 67 66 66 66 66 67 67 67 67 67 67 67 67 67 67 67 67 67 67 67 31 
0 0 0 0 0 0 0 0 0 0 67 67 67 67 0 0 30 67 0 0 0 0 0 67 67 0 0 0 0 0 67 67 67 67 67 67 68 68 68 67 68 68 68 68 68 68 68 67 67 31 
0 0 0 0 0 0 0 0 0 0 0 67 67 0 0 0 30 68 0 0 0 0 0 67 67 0 0 0 0 0 67 67 67 67 67 67 13 8 14 67 13 9 9 9 9 9 14 67 67 31 
0 0 0 0 0 0 0 0 0 0 0 0 0 0 0 0 28 10 67 0 0 0 67 67 67 67 0 0 0 67 66 66 66 66 67 67 31 32 25 67 24 33 0 0 0 0 30 67 67 31 
0 0 0 0 0 0 0 0 0 0 0 0 0 0 0 0 0 28 68 68 68 68 68 67 67 68 68 68 68 68 29 0 0 28 66 66 29 30 67 6 67 24 18 18 18 18 25 67 67 31 
0 0 0 0 0 0 0 0 0 0 0 0 0 0 0 0 0 28 10 10 10 12 8 67 67 10 8 8 8 10 29 0 0 0 0 0 0 30 1 67 67 9 9 9 9 9 10 67 67 31 
0 0 0 0 0 0 0 0 0 0 0 0 0 0 0 0 0 0 0 0 0 0 28 67 67 29 0 0 0 0 0 0 0 0 0 0 0 30 6 67 67 67 67 67 67 67 67 67 67 31 
0 0 0 0 0 0 0 0 0 0 0 0 0 0 0 0 0 0 0 0 0 0 30 67 67 31 0 0 0 0 0 0 0 0 0 0 0 30 67 67 67 68 68 68 68 68 68 67 67 31 
0 0 0 0 0 0 0 0 0 0 30 67 67 31 0 0 0 0 0 0 0 0 30 67 67 31 0 0 0 0 0 0 0 0 0 0 0 30 67 1 67 13 9 9 9 9 14 67 67 31 
0 32 18 18 18 18 18 18 18 18 25 67 67 24 35 33 0 0 0 0 30 9 9 67 67 9 9 31 0 0 0 0 0 0 0 0 0 30 69 67 69 31 0 0 0 0 30 67 67 31 
0 30 9 9 9 9 9 9 9 9 9 67 67 9 9 31 0 0 32 18 25 67 67 67 67 67 67 31 0 0 0 0 0 0 0 0 0 28 14 68 13 29 0 0 0 0 30 67 67 31 
0 30 67 67 67 67 67 67 67 67 67 67 67 67 67 16 18 18 17 9 9 67 67 67 67 67 67 9 9 31 0 0 0 0 0 0 0 0 28 10 29 0 0 0 0 0 30 67 67 31 
0 30 67 67 67 67 67 67 67 67 67 67 67 67 67 9 9 9 9 67 67 67 67 67 67 67 67 67 67 31 0 0 0 0 0 0 0 0 0 0 0 0 0 0 0 0 30 67 67 31 
0 30 67 67 67 67 67 67 67 67 67 67 67 67 67 67 67 67 67 67 67 67 67 67 67 67 67 67 67 31 0 32 18 18 33 32 18 18 33 0 0 0 0 0 0 0 30 67 67 31 
0 30 67 67 67 67 67 67 67 67 67 67 67 67 67 68 68 68 68 67 67 67 67 67 67 67 67 67 67 31 0 30 9 9 31 30 9 9 31 0 0 0 0 0 32 18 25 67 67 31 
0 30 67 67 67 67 67 67 67 67 67 67 67 67 67 13 9 9 14 68 68 67 67 67 67 67 67 68 68 31 0 30 67 67 16 17 67 67 31 0 32 18 18 18 25 9 9 67 67 31 
0 30 67 67 67 67 67 67 67 67 67 67 67 67 67 31 0 0 28 8 14 67 67 67 67 67 67 13 9 29 0 30 67 67 8 8 67 67 31 0 30 10 10 10 10 67 67 67 67 31 
0 30 67 67 67 67 67 67 67 67 67 67 67 67 67 31 0 0 32 34 17 67 67 67 67 67 67 24 34 26 26 25 67 67 67 67 67 67 31 0 30 67 67 67 67 67 67 67 67 31 
0 30 67 67 67 67 67 67 67 67 67 67 67 67 67 31 0 0 30 67 67 67 67 67 67 67 67 67 67 67 67 67 67 67 67 67 67 67 31 0 30 67 67 4 4 67 67 67 67 31 
0 30 67 67 67 67 67 67 67 67 67 67 67 67 67 31 0 0 30 67 67 67 67 67 67 67 67 67 67 67 67 67 67 67 67 67 67 67 66 66 66 67 67 0 0 2 67 67 67 31 
0 30 67 67 67 67 67 67 67 67 67 67 67 67 67 31 0 0 30 67 67 67 67 67 67 67 67 67 67 68 68 68 67 67 67 67 67 67 67 67 67 67 67 0 0 0 0 0 0 31 
0 30 68 68 68 68 68 68 68 68 68 68 68 68 68 31 0 0 30 68 68 68 67 67 67 67 68 68 68 13 9 14 68 68 68 68 68 67 67 6 7 67 67 67 67 67 67 67 67 31 
0 28 8 8 8 8 8 8 8 8 8 8 8 8 8 29 0 0 28 8 8 14 68 68 68 68 13 9 9 29 0 28 9 9 9 9 9 69 69 69 69 69 69 69 69 69 69 69 69 31 
0 0 0 0 0 0 0 0 0 0 0 0 0 0 0 0 0 0 0 0 0 28 9 9 9 9 29 0 0 0 0 0 0 0 0 0 28 9 9 9 9 9 9 9 9 12 12 12 12 29 
